11111111111111111111111111111111111111111111111111
100PE1CMEEM11CCCECM1CEMM010EC1E0C1EC0E0E0E101001E1
1C000111C11CECC01000110C0E00CE100EC000E01EC1E0C1C1
110C100E10C00C10E0EECCE1110C1E10CCCC0C1E0E1E0CEC01
11C1EEC1CEECE010CEC0CCC11CCCCEC1CCEEE001EE010E1111
1EE0CCEE11EC11EE0000E0CCE1000E1E1EECE1011C1E0EE001
11EECEC110E1C10E0EEECEE010EC10000111011CC11C010101
1CE000EEE0C0101CC11C01CE001CC0ECCE00E1C00E10001C11
1C1EE1CECEC1CE00C01CC000EEC0EEEE0EE0E10CECC110E011
1CE1E110CE1CC1E1C0C0ECEEC1ECE0CCEC0111C1E11CE1EE01
101CC00101E101C1E0ECCC0001CE1E0C1EEEEC0001CEC001E1
1EC0000C111C1111E1EC0E1EE1E0011C0ECEEC0EEEEC1CE101
100E1110EC10001E00E1101E01C1CE11ECCE1CCC0E0CC0C101
1CE1C11EE10E1110E0CE1CE0EEE0E01E000C010C0CCEC10E11
1E1EEEE1101CEEE0100EEECCE1EE0EE100CCCE110C00100EC1
1E011C0E1E001C001ECCE010E11EC11CEECECE0E1CECCE00E1
1EE11EEEC1E0010CE10ECE1CECC1C100EE10C000C11CEE0CC1
1EC0011E1E1C11C1CC0E0E0000C100001E0EC10CCEE0CEE1C1
1EC111C11C10E1E0C1E1E0E00EE11ECC10CCC110E111ECEE01
11111111111111111111111111111111111111111111111111